11111111111111111111111111111111111111111
00100000100000000010001010001000000000001
10111011101110111010101010101010111111111
10001000100010001010101000101010100000001
11101010111011101010101111101010101111101
10101010000010001000101000100010000000101
10101011111110111111101010111111111111101
10101000000010100000100010000000000010001
10101111111110101111111111111111111010111
10100000100010100000000000100000001010001
10111110101010111010111110101110111011101
10001000101010001010001000100010000010001
10101011101011101110101011111011111110111
10100010001000100010101000100010000000001
10111110111110101011101111101111111011101
10100010001010101000101000001000001010001
10111010101010111110101011111011101110101
10001000101010001000100010001000100010101
11101111101011101011101110101110111010101
10000000001000000010000000100000100000100
11111111111111111111111111111111111111111
