11111111111111111111111111111111111111111
00001000000010001000000000000010000000001
11101011111010101011101111111011101111101
10101000001000100000101000001000001000101
10101111101111111110101011101111111011101
10101000000000100010101000100000001000101
10101111111111101011101011111011111010101
10001000100010001000001010001010000010001
10111010101010111011111110101010111111111
10100010001010100010001000101010100000001
10101111111010111110101011101010111011101
10001000100010000000100000101010100010101
11111110101110111111111111101010101110101
10001000100010000000000010001000100010001
10101011111011101111111110111011101010111
10100010000010101000100000101010001010101
10111110111110101010101111101011111010101
10000010100010001010001000001010000010101
10111010101011111011111010111010111110101
10001000001000000010000010000000100000000
11111111111111111111111111111111111111111